.,#,.,.,.,#,.,.,#,.
.,.,.,.,.,.,.,.,.,.
.,.,.,.,.,.,.,.,.,.
.,.,.,.,.,.,.,.,.,.
S,H,H,H,H,H,H,H,H,G
